
    [egg_info.writers]
    datapkg_index.txt=setuptools.command.egg_info:write_arg
    
    [console_scripts]
    datapkg=datapkg.cli:main
    dpm=datapkg.cli:main

    [datapkg.cli]
    help = datapkg.cli:HelpCommand
    about = datapkg.cli.standard:AboutCommand
    license = datapkg.cli.standard:LicenseCommand
    man = datapkg.cli.standard:ManCommand
    list = datapkg.cli.standard:ListCommand
    search = datapkg.cli.standard:SearchCommand
    info = datapkg.cli.standard:InfoCommand
    dump = datapkg.cli.standard:DumpCommand
    init = datapkg.cli.standard:InitCommand
    create = datapkg.cli.standard:CreateCommand
    register = datapkg.cli.standard:RegisterCommand
    update = datapkg.cli.standard:UpdateCommand
    install = datapkg.cli.download:DownloadCommand
    upload = datapkg.cli.upload:UploadCommand

    [datapkg.index]
    simple = datapkg.index.base:SimpleIndex
    file = datapkg.index.base:FileIndex
    ckan = datapkg.index.ckan:CkanIndex
    db = datapkg.index.db:DbIndexSqlite
    egg = datapkg.index.egg:EggIndex

    [datapkg.distribution]
    json = datapkg.distribution:JsonDistribution

    [datapkg.resource_downloader]
    simple = datapkg.download:ResourceDownloaderSimple 
    