
    [egg_info.writers]
    datapkg_index.txt=setuptools.command.egg_info:write_arg
    
    [console_scripts]
    dpm=dpm.cli:main

    [dpm.cli]
    help = dpm.cli:HelpCommand
    about = dpm.cli.standard:AboutCommand
    license = dpm.cli.standard:LicenseCommand
    man = dpm.cli.standard:ManCommand
    list = dpm.cli.standard:ListCommand
    search = dpm.cli.standard:SearchCommand
    info = dpm.cli.standard:InfoCommand
    dump = dpm.cli.standard:DumpCommand
    init = dpm.cli.standard:InitCommand
    setup = dpm.cli.standard:SetupCommand
    register = dpm.cli.standard:RegisterCommand
    update = dpm.cli.standard:UpdateCommand
    download = dpm.cli.download:DownloadCommand
    clone = dpm.cli.download:DownloadCommand
    upload = dpm.cli.upload:UploadCommand
    push = dpm.cli.push:PushCommand

    [dpm.index]
    simple = dpm.index.base:SimpleIndex
    file = dpm.index.base:FileIndex
    ckan = dpm.index.ckan:CkanIndex
    egg = dpm.index.egg:EggIndex

    [dpm.distribution]
    json = dpm.distribution:JsonDistribution

    [dpm.resource_downloader]
    simple = dpm.download:ResourceDownloaderSimple 
    