[slapos.recipe.nosqltestbed.plugin]
kumo = slapos.recipe.nosqltestbed.kumo:KumoTestBed

[zc.buildout]
generic.kumofs = slapos.recipe.generic_kumofs:Recipe
kumofs = slapos.recipe.kumofs:Recipe
equeue = slapos.recipe.equeue:Recipe
duplicity = slapos.recipe.duplicity:Recipe
erp5.test = slapos.recipe.erp5_test:Recipe
check_port_listening = slapos.recipe.check_port_listening:Recipe
apache.zope.backend = slapos.recipe.apache_zope_backend:Recipe
zeo = slapos.recipe.zeo:Recipe
stunnel = slapos.recipe.stunnel:Recipe
generic.cloudooo = slapos.recipe.generic_cloudooo:Recipe
generic.onetimeupload = slapos.recipe.generic_onetimeupload:Recipe
dropbear.add_authorized_key = slapos.recipe.dropbear:AddAuthorizedKey
kvm.frontend = slapos.recipe.kvm_frontend:Recipe
shell = slapos.recipe.shell:Recipe
publishurl = slapos.recipe.publishurl:Recipe
mysql = slapos.recipe.mysql:Recipe
sshkeys_authority = slapos.recipe.sshkeys_authority:Recipe
tidstorage = slapos.recipe.tidstorage:Recipe
libcloud = slapos.recipe.libcloud:Recipe
generate.mac = slapos.recipe.generatemac:Recipe
lamp.static = slapos.recipe.lamp:Static
xwiki = slapos.recipe.xwiki:Recipe
nbdserver = slapos.recipe.nbdserver:Recipe
generic.memcached = slapos.recipe.generic_memcached:Recipe
sshkeys_authority.request = slapos.recipe.sshkeys_authority:Request
seleniumrunner = slapos.recipe.seleniumrunner:Recipe
slaprunner = slapos.recipe.slaprunner:Recipe
publish = slapos.recipe.publish:Recipe
fontconfig = slapos.recipe.fontconfig:Recipe
dropbear = slapos.recipe.dropbear:Recipe
lamp = slapos.recipe.lamp:Request
shellinabox = slapos.recipe.shellinabox:Recipe
simplelogger = slapos.recipe.simplelogger:Recipe
lamp.simple = slapos.recipe.lamp:Simple
testnode = slapos.recipe.testnode:Recipe
generic.zope.zeo.client = slapos.recipe.generic_zope_zeo_client:Recipe
generate.erp5.tidstorage = slapos.recipe.generate_erp5_tidstorage:Recipe
memcached = slapos.recipe.memcached:Recipe
sphinx = slapos.recipe.sphinx:Recipe
generic.mysql = slapos.recipe.generic_mysql:Recipe
generic.zope = slapos.recipe.generic_zope:Recipe
generate.cloudooo = slapos.recipe.generate_cloudooo:Recipe
notifier.notify = slapos.recipe.notifier:Notify
kvm = slapos.recipe.kvm:Recipe
mydumper = slapos.recipe.mydumper:Recipe
pwgen = slapos.recipe.pwgen:Recipe
symbolic.link = slapos.recipe.symbolic_link:Recipe
novnc = slapos.recipe.novnc:Recipe
erp5.update = slapos.recipe.erp5_update:Recipe
certificate_authority.request = slapos.recipe.certificate_authority:Request
zabbixagent = slapos.recipe.zabbixagent:Recipe
vifib = slapos.recipe.vifib:Recipe
cron.d = slapos.recipe.dcron:Part
sheepdogtestbed = slapos.recipe.sheepdogtestbed:SheepDogTestBed
libcloudrequest = slapos.recipe.libcloudrequest:Recipe
java = slapos.recipe.java:Recipe
certificate_authority = slapos.recipe.certificate_authority:Recipe
lockfile = slapos.recipe.lockfile:Recipe
mkdirectory = slapos.recipe.mkdirectory:Recipe
haproxy = slapos.recipe.haproxy:Recipe
cron = slapos.recipe.dcron:Recipe
softwaretype = slapos.recipe.softwaretype:Recipe
notifier.callback = slapos.recipe.notifier:Callback
pbs = slapos.recipe.pbs:Recipe
erp5scalabilitytestbed = slapos.recipe.erp5scalabilitytestbed:Recipe
nosqltestbed = slapos.recipe.nosqltestbed:NoSQLTestBed
waitfor = slapos.recipe.waitfor:Recipe
request = slapos.recipe.request:Recipe
logrotate = slapos.recipe.logrotate:Recipe
helloworld = slapos.recipe.helloworld:Recipe
urlparse = slapos.recipe._urlparse:Recipe
siptester = slapos.recipe.siptester:SipTesterRecipe
lamp.request = slapos.recipe.lamp:Request
proactive = slapos.recipe.proactive:Recipe
logrotate.d = slapos.recipe.logrotate:Part
apache.frontend = slapos.recipe.apache_frontend:Recipe
apacheproxy = slapos.recipe.apacheproxy:Recipe
davstorage = slapos.recipe.davstorage:Recipe
apachephp = slapos.recipe.apachephp:Recipe
erp5testnode = slapos.recipe.erp5testnode:Recipe
notifier = slapos.recipe.notifier:Recipe
dropbear.client = slapos.recipe.dropbear:Client

